BBBBBBBBBBBBBBBBBBBBBBBBBBBBBBBB
................................
................................
................................
................................
................................
................................
................................
................................
................................
................................
................................
................................
................................
................................
................................
................................
................................
................................
................................
................................
................................
................................
................................
................................
................................
................................
................................
B..............................B
B..............................B
B..............................B
BBBBBBBBBBBBBBBBBBBBBBBBBBBBBBBB
